Sugestão para nomenclatura de componentes Delphi
________________________________________________________________________________________

Segue abaixo a nossa sugestão para padronização de nomenclatura de componentes para
o Delphi:

Use	Para o(s) seguinte(s) componente(s) e seus descendentes
===	=============================================================================
act	TActionList, TAction
amt	TAnimate
bev	TBevel
btm	TBatchMove
btn	TButton, TSpeedButton, TBitBtn
cbr	TCoolBar
chk	TCheckBox, TDBCheckBox
cht	TChart, TDBChart, TQRChart
con TFDConnection
clg	TColorDialog
cmb	TComboBox, TDBComboBox, TDBLookUpComboBox
ctb	TControlBar
dcc	TDdeClientConv
dci	TDdeClientItem
dlg	TOpenDialog, TSaveDialog
dsc	TDataSource
dsc	TDdeServerConv
dsi	TDdeServerItem
dtb	TDatabase
dtp	TDateTimePicker
edt	TEdit, TMaskEdit
flg	TFontDialog
frm	TForm
grd	TStringGrid, TDrawGrid, TDBGrid, TDBCtrlGrid
grp	TGroupBox, TRadioGroup, TDBRadioGroup
hdc	THeaderControl
htk	THotKey
ilg	TOpenPictureDialog, TSavePictureDialog
img	TImage, TDBImage, TImageList, TQRImage, TQRDBImage
lbl	TLabel, TQRLabel
lst	TListBox, TDBListBox, TCheckListBox, TDBLookUpListBox
lvw	TListView
mcd	TMonthCalendar
mem	TMemo, TDBMemo, TQRMemo, TQRExprMemo
mpl	TMediaPlayer
ntb	TNestedTable
nvg	TDBNavigator
ole	TOleContainer
pgb	TProgressBar, TGauge
pgc	TPageControl
pgs	TPageScroller
plg	TPrintDialog, TPrinterSetupDialog
pnb	TPaintBox
pnl	TPanel
qcr	TQRCompositeReport
qcs	TQRCSVFilter
qex	TQRExpr
qht	TQRHTMLFilter
qpw	TQRPreview
qrb	TQRBand, TQRChildBand
qrg	TQRGroup
qrp	TQuickReport
qry	TQuery,TFDQuery
qsb	TQRStringsBand
qsd	TQRSubDetail
qsy	TQRSysData
qtf	TQRTextFilter
rch	TRichEdit, TDBRichEdit, TQRRichText, TQRDBRichText
rdb	TRadioButton
scb	TScrollBar
ses	TSession
shp	TShape, TQRShape
spl	TSplitter
spn	TSpinEdit
srl	TScrollBox
stb	TStatusBar
stp	TStoredProc
tab TTabSheet
tbc	TTabControl
tbl	TTable
tbr	TToolBar
tkb	TTrackBar
tlg	TFindDialog, TReplaceDialog
tmr	TTimer
tvw	TTreeView
txt	TStaticText, TDBText, TQRBText
udn	TUpDown
ups	TUpdateSQL

* os componentes de terceiros e demais componentes não citados na relação devem
  seguir a padronização de nomenclatura da sua classe pai.
  
  Fonte: https://www.udemy.com/course/aprenda-delphi-e-lazarus-do-zero/

*
